z : maLe
y : wthv
x : yZCq
w : jErY
v : sOlc
u : xVfp
V : mWle
U : wufv
T : yzkq
S : jNPY
R : sRdc
Q : xoTp
P : Aagm
O : Xtiw
N : FZny
M : eELj
L : vOhs
K : qVCx
D : jWTY
s : XUPw
C : sugc
r : FGdy
B : xzip
q : eMTj
A : ANnm
p : vIgs
E : yQdq
t : AHkm
F : wIPv
G : mMke
H : pGfF
I : cUlX
J : YHrA
W : pQrF
X : cICX
Y : YMhA
Z : qGLx
a : vUns
b : eHij
c : FVgy
d : XOTw
e : AEdm
f : xZPp
g : stkc
h : jafY
i : yolq
j : wRrv
k : mNCe
l : pzhF
m : cuLX
n : YWnA
o : qQix
